11 11
###########
###########
###########
###.....###
###c###...#
##.@.c..c.#
##.hh#.c.##
###hh#...##
###########
###########
###########