11 11
###########
###########
##@..######
##.cc######
##.c.###h##
####.###h##
####....h##
###...#..##
###...#####
###########
###########
