11 11
###########
###########
###########
######..h##
###...c.x##
###.cc.ch##
####@##hh##
###########
###########
###########
###########