10 7
##########
##.....###
##c###...#
#.@.c..c.#
#.hh#.c.##
##hh#...##
##########