11 11
###########
#####h#####
#####.#####
#####c#####
#####.#####
#h.c.@.c.h#
#####.#####
#####c#####
#####.#####
#####h#####
###########