11 11
###########
###########
####@.#####
####.c..###
#####.#.###
###h#.#..##
###hc..#.##
###h...c.##
###########
###########
###########